1	W AH N
2	T UW
3	TH R IY
4	F OW R
5	F AY V
6	S IH K S
7	S EH V AH N
8	EY T
9	N AY N
BLUE	B L UW
GARAGE	G ER AA ZH
GIVE	G IH V
HOUSE	HH AW S
IN	IH N
IS	IH Z
JUL	JH AH L
MUSIC	M Y UW Z IH K
OKAY	OW K EY
OPEN	OW P AH N
PASSWORD	P AE S W ER D
PI	P AY
PLAY	P L EY
RAMONA	R AH M OW N AH
SHUTDOWN	SH AH T D AW N
START	S T AA R T
THE	DH AH
THE(2)	DH IY
TIME	T AY M
TRANSLATOR	T R AE N S L EY T ER
TRANSLATOR(2)	T R AE N Z L EY T ER
WEATHER	W EH DH ER
WHAT	W AH T
WHAT(2)	HH W AH T
